###########################
#           #             #
#   ###     #   ######### #
#   #           #       # #
#   #   ############### # #
#       #               # #
# ##### #   #########   # #
#           #           # #
#   ####### #   ######### #
#                         Q
###########################
