████████████████████████
████████████████████████
████████████████████████
███   ███████        ███
███   ███████ Q      ███
███   ███████        ███
███   ████████████   ███
███   ████████████   ███
███                  ███
███                  ███
███                  ███
████████████████████████
████████████████████████
████████████████████████