███████████████████████████████████████████████
█     █       █   █       █     █           Q █
█ ███ █ █████ █ █ █ █████ █ ███ █ ███████ ███ █
█ █   █     █ █ █   █   █   █ █   █     █   █ █
█ █ █████ █ █ █ █████ █ █████ █████ ███ ███ █ █
█ █     █ █ █ █       █       █     █   █   █ █
█ █████ █ █ █ █████████ █████ █ █████ ███ █ █ █
█     █ █ █ █     █     █   █ █     █   █ █ █ █
█████ █ █ █ █████ █ █████ █ █ █████ ███ █ █ █ █
█   █ █ █ █     █ █   █   █ █     █   █ █ █ █ █
█ █ █ █ █ █████ █ ███ █ ███ █████ █ █ █ █ █ █ █
█ █ █   █     █ █   █ █   █     █ █ █   █ █ █ █
█ █ ███████████ ███ █ ███ █████ █ █ █████ █ █ █
█ █         █     █ █   █     █ █ █     █ █ █ █
█ █████████ █ █████ ███ █████ █ █ █████ █ █ █ █
█       █   █     █   █     █ █   █   █   █ █ █
███████ █ ███████ ███ █████ █ █████ █ █████ █ █
█       █       █   █     █ █       █       █ █
█ █████████████ ███ █████ █ █████████████████ █
█             █   █     █ █                   █
█████████████ ███ █████ █ █████████████████████
█         █     █     █ █                     █
█ ███████ ███████████ █ █████████████████████ █
█ █     █       █     █                     █ █
█ █ ███ ███████ █ ███████████████████████ █ █ █
█ █   █       █ █                       █ █ █ █
█ █████ █████ █ █████████████████████ █ █ █ █ █
█     █     █ █                     █ █ █ █ █ █
█████ █████ █ ███████████████████ █ █ █ █ █ █ █
█     █     █                   █ █ █ █ █ █ █ █
█ █████ █████████████████████ █ █ █ █ █ █ █ █ █
█     █                     █ █ █ █ █ █ █ █ █ █
█████ ███████████████████ █ █ █ █ █ █ █ █ █ █ █
█                       █ █ █   █   █   █   █ █
█ █████████████████████ █ █ █████████████████ █
█                       █                     █
███████████████████████████████████████████████
