███████████████████████████████████████████████
█     █       █       █       █               █
█ ███ █ █████ █ █████ █ █████ █ ███████████ █ █
█   █ █     █   █   █   █   █   █         █ █ █
███ █ █████ █████ █ █████ █ █████ ███████ █ █ █
█   █     █       █       █       █     █ █ █ █
█ ███████ █████████████████████████ ███ █ █ █ █
█       █                           █ █ █ █ █ █
█ █████ █████████████████████████████ █ █ █ █ █
█ █   █                               █ █ █ █ █
█ █ █ █████████████████████████████████ █ █ █ █
█ █ █                                   █ █ █ █
█ █ ███████████████████████████████████ █ █ █ █
█ █                                     █ █ █ █
█ █████████████████████████████████████ █ █ █ █
█                                       █ █ █ █
█ ███████████████████████████████████████ █ █ █
█                                         █ █ █
█ █████████████████████████████████████████ █ █
█                                           █ █
█ ███████████████████████████████████████████ █
█                                             █
█████████████████████████████████████████████ █
█                                             █
█ █████████████████████████████████████████████
█                                             █
█ ███████████████████████████████████████████ █
█                                           █ █
█ █████████████████████████████████████████ █ █
█                                         █ █ █
█ ███████████████████████████████████████ █ █ █
█                                       █ █ █ █
█ █████████████████████████████████████ █ █ █ █
█                                     █ █ █ █ █
█ ███████████████████████████████████ █ █ █ █ █
█                                       █   Q █
███████████████████████████████████████████████
