██████████
█        █
█   █    █
█        █
██████████
