████████████████████████████████████████████████████████████████████████████████████████████████████
█                                                                                                  █
█                                                                                                  █
█                                                                                                  █
█                                                                                                  █
███████████████████████████████████████████████████████████████████████████████████████████████    █
█                                                                                                  █
█                                                                                                  █
█                                                                                                  █
█                                                                                                  █
█         ███████████████          ███████████████          ███████████████                        █
█         ███████████████          ███████████████          ███████████████                        █
█         ███████████████          ███████████████          ███████████████                        █
█         ███████████████          ███████████████          ███████████████                        █
█         ███████████████          ███████████████          ███████████████                        █
█         ███████████████          ███████████████          ███████████████                        █
█         ███████████████          ███████████████          ███████████████                        █
█         ███████████████          ███████████████          ███████████████                        █
█                                                                                                  █
█                                                                                                  █
█                                                                                                  █
█                                                                                                  █
█                                                                                                  █
█                                                                                                  █
█                                                                                                  █
█         ███████████████          ███████████████          ███████████████                        █
█         ███████████████          ███████████████          ███████████████                        █
█         ███████████████          ███████████████          ███████████████                        █
█         ███████████████          ███████████████          ███████████████                        █
█         ███████████████          ███████████████          ███████████████                        █
█         ███████████████          ███████████████          ███████████████                        █
█         ███████████████          ███████████████          ███████████████                        █
█         ███████████████          ███████████████          ███████████████                        █
█                                                                                                  █
█                                                                                                  █
█                                                                                                  █
█                                                                                                  █
█                                                                                                  █
█                                                                                                  █
█                                                                                                  █
█                                                                                                  █
█                                                                                                  █
█                                                                                                  █
█                                                                                                  █
█                                                                                                  █
██    ██████████████████████████████████████████████████████████████████████████████████████████████
█                                                                                                  █
█                                                                                                Q █
█                                                                                                  █
████████████████████████████████████████████████████████████████████████████████████████████████████